WWWWWWWWWWWWWWWWWWWWWW
W                    W
W                    W
W                    W
W                    W
W                    W
W                    W
W                    W
W       S  S  S      W
W      WWWWWWWWWW    W
W      W             W
WWWW   W          SSSW
W      W   WWWWWWWWWWW
W     SW              
W    WWW              
W      WSSS   E        
WWWWWWWWWWWWWWWWWWWWWW
stop
WWWWWWWWWWWWWWWWWWWWWW
W           W        W
W           W         
W           W         
W           W    E    
W           W   WWWWWW
W           W    WWWWW
W           W    WWWWW
W      W    WW   WWWWW
W      W    W    WWWWW
W      W         WWWWW
WWWW   W        WWWWWW
W      W         WWWWW
      SW     W   WWWWW
     WWW         WWWWW
       WSSSSSSSSSWWWWW
WWWWWWWWWWWWWWWWWWWWWW
stop
WWWWWWWWWWWWWWWWWWWWWW
W               W     
                W         
                W         
                W        
WWWWWWWWW       W   WW
W               W    W
W               W    W
W   E     S  S  WW   W
W   WWWWWWWWWWWWW    W
W                    W
W                    W
W        W          WW
W   WW   W           W
W        W   W   W   W
WSSSSSSSSWSSSSSSSSSSSW
WWWWWWWWWWWWWWWWWWWWWW
stop
WWWWWWWWWWWWWWWWWWWWWW
W                    W
                     W
                     W
                     W
W                    W
WWWWWWWWWWWWWWWWW    W
W                    W
W                    W
W    H E E  E H    SSW
W    WWWWWWWWWWWWWWWWW
W                     
W                     
W    WW  WWWWW  WW   W
W                    W
WSSSSSSSSSSSSSSSSS   W
WWWWWWWWWWWWWWWWWWWWWW
stop
WWWWWWWWWWWWWWWWWWWWWW
W                    W
W                    W
W                    W
W         WW         W
W        W           W
W       W            W
W      W             W
W     W              W
W    W               W
    W                W
   W     SSSSSSSSSSSSW
WWW      WWWWWWWWWWWWW
W                     
W                     
W          HH         
WWWWWWWWWWWWWWWWWWWWWW
stop
WWWWWWWWWWWWWWWWWWWWWW
W                    W
W                    W
W                    W
W                    W
W                    W
W                    W
W                    W
W                    W
W                    W
W                    W
W                    W
WW                  WW
      B              W
                     I
                     I
WWWWWWWWWWWWWWWWWWWWWW
stop