WWWWWWWWWWWWWWWWWWWWWW
W                    W
W                    W
W                    W
W                    W
W                    W
W                    W
W                    W
W                    W
W                    W
W                    W
W                    W
W                    W
W                     
W                      
WI                   
WWWWWWWWWWWWWWWWWWWWWW
stop
WWWWWWWWWWWWWWWWWWWWWW
W                    W
W                    W
W                    W
W                    W
W             W      W
W        e    W      W
W        WWWWWW      W
W             W      W
W  E          W   WWWW
W  WWWWW      W      W
W             W      W
W        E    WS     W
        WWWWWWWWWWW   
              W       
           D  WSSSS   
WWWWWWWWWWWWWWWWWWWWWW
stop
WWWWWWWWWWWWWWWWWWWWWW
W                    W
W                    W
W                    W
W                    W
W                    W
W                    W
W                    W
W                    W
W                    W
W                    W
W                    W
W                    W
    W                W
              b      W
         SSSS        W
WWWWWWWWWWWWWWWWWWWWWW
stop
WWWWWWWWWWWWWWWWWWWWWW
W                    W
W                    W
W                    W
WI S  H  S  S        W
WWWWWWWWWWWWWW       W
W                    W
W       E      E  SSSW
W       WWWWWWWWWWWWWW
W                    W
W                    W
W     S E            W
W   WWWWWWWWW        W
W                    W
W                    W
W D                  W
WWWWWWWWWWWWWWWWWWWWWW
stop
WWWWWWWWWWWWWWWWWWWWWW
W                    W
W                    W
W                    W
W      S  U   S      W
W     WWWWWWWWWW     W
W                    W
W                    W
We              e    W
WWWWWW          WWWWWW
W                    W
W        E           W
W        WWWWW       W
W                    W
W                    I
W  e   S   D  eS     I
WWWWWWWWWWWWWWWWWWWWWW
stop
WWWWWWWWWWWWWWWWWWWWWW
W                    W
W                    W
W                    W
W                    W
W                    W
W                    W
W                    W
W    WWWWWWWWWWWW    W
W                    W
W                    W
W                    W
WWW B              WWW
W                    W
                     I
                     I
WWWWWWWWWWWWWWWWWWWWWW
stop
WWWWWWWWWWWWWWWWWWWWWW
W                    W
W                    W
W                    W
W U                  W
WWWWWW   W           W
W    W               W
W    W       E       W
W    W      WWWWWW   W
W    W               W
W    W S             W
W    WWWWWW          W
W    W               W
W    W        S      W
W    W       WWW      
W    W                
WWWWWWWWWWWWWWWWWWWWWW
stop
WWWWWWWWWWWWWWWWWWWWWW
W                    W
W         U          W
W        WWWW        W
W                    W
W    e      e        W
W    WWWWWWWWWWWW    W
W                    W
W                    W
W  E           E     W
WWWWWWWW      WWWWWWWW
W                    W
W                    W
W        E           W
         WWWWW        
        S     S       
WWWWWWWWWWWWWWWWWWWWWW
stop
WWWWWWWWWWWWWWWWWWWWWW
W                    W
W                    W
W                    W
W                    W
W                    W
W                    W
W                    W
W                    W
W                    W
W                    W
W                    W
W                    W
    W                W
              b      W
         SSSS        W
WWWWWWWWWWWWWWWWWWWWWW
stop